WWWWWWWWWWWWWWWWWWWWW
WPPPPPPPPPWPPPPPPPPPW
WPWWWPWWWPWPWWWPWWWPW
WPPPPPPPPPPPPPPPPPPPW
WPWWWPWPWWWWWPWPWWWPW
WPPPPPWPPPWPPPWPPPPPW
WWWWWPWWWPWPWWWPWWWWW
WWWWWPWPPPPPPPWPWWWWW
WWWWWPWPWWWWWPWPWWWWW
T    PPPWGGGWPPP    T
WWWWWPWPWW WWPWPWWWWW
WWWWWPWPPPGPPPWPWWWWW
WWWWWPWPWWWWWPWPWWWWW
WPPPPPPPPPWPPPPPPPPPW
WPWWWPWWWPWPWWWPWWWPW
WPPPWPPPPPPPPPPPWPPPW
WWWPWPWPWWWWWPWPWPWWW
WPPPPPWPPPWPPPWPPPPPW
WPWWWWWWWPWPWWWWWWWPW
WPPPPPPPPPPPPPPPPPPPW
WWWWWWWWWWWWWWWWWWWWW